1111111111111111111111
1E00000000000000000001
1000000000000000000001
1000000000000000000C01
1000000000000000000001
1000000000000000000001
1000000000000000000001
1000000000000000000001
1P0C00C00000C0000C0001
1111111111111111111111
