1111111111111111111111
100000000000E000000001
1000322222222000000001
1000300000000000000001
100030C0C0C0C0C0C00001
1000222222222222223001
1000000000000000003001
1000000000000000003001
100P0000C0C0C0C0003001
1111111111111111111111
