1111111111111111111111111111111111
1E00000000000000000000000000000001
1000000000000000000000000000000001
1000000000000000000C00000000000001
1000000000000000000000000000000001
1P0C00C00000C0000C00000C0000C00001
1111111111111111111111111111111111
