1111111111111111111111
10000000000000000000P1
1E00000322222230032221
1222300300000030030001
1000300300000022220001
1000300300000000000001
1000300222222222230001
1000300000000000030001
1000300000C00000030001
1000222222222222220001
1000000000000000000001
1111111111111111111111
